Level 1
###########
# z  %  z #
#    %    #
#    %    #
#    %    #
#    %    #
#    %    #
#    %    #
#$$$$%$$$$#
#    %    #
#    %    #
#a  d%b  e#
#    %    #
#1  4%5  2#
#    %    #
#$$$$%$$$$#
#  . %   .#
#  @ %  = #
#    %    #
###########
