######
#  . #
#    #
#@   #
######
